1111111111
100E000001
1000000001
10000P0001
100C000C01
1111111111